11111111111111111111111111111
10000000000000000000000000001
10000000000000000000000000001
10000000000000000000000000001
1C00000000000000000000C000001
100000000000E0000000000000001
10000000C00000000000000000001
10000000000000000000000000001
10000000000000000000000000001
10000000000000000C00000000001
10000000C000000000000000000C1
10P00000000000000000000000001
10000000000000000000000000001
10000000000000C00000000000001
11111111111111111111111111111
