1111111111111
1000000E00001
111100X0X0011
11C1100X00011
1100100000C01
100X100X11111
10110000C0001
1011111111101
1000000000001
100C00000C001
100000X000001
100000X000001
1P000X0000001
1C00011111111
1111C11111111
11110111100C1
1111011111011
1111001111011
1111100000011
1111111111111
