1111111111111111111111111111111111111111111111111111111
1000011111000000000011111111110000011111000000000000001
1P0001111100000C00001111111111000001111100000000C000001
10000111110000000000111000011100E0011111000000000000001
1000C11111111110000011100001110000011111111110000000001
1000011111111110000011111111110000011111111110000000001
1000011111111110000011111111110000011111111110000000001
10000000000000000C00000000000000000000C0000000000000001
1111111111111111111111111111111111111111111111111111111
