1111111111111111111111111111111111111111111111111111111
1000011111000000000011111111110000011111000000000000001
100001111100000C00001111111111000001111100000000C000001
1000011111000000000011100001110000011111000000000000001
1000C11111111110000011100001110000011111111110000000001
1000011111111110000011111111110000011111111110000000001
10P00111111111100000111111111100E0011111111110000000001
10000000000000000C00000000000000000000C0000000000000001
1111111111111111111111111111111111111111111111111111111
