00000100000
00001010000
00010001000
00100C00100
01000000010
10C00P00C01
01000000010
00100C00100
00010001000
00001E10000
00000100000