111111111
10000E001
100C00001
111111111
