11111111
1PE00000
10C11111
11111111
