1111
11E1
1P11
1111
1111
1C11
1111
