1111
1111
1301
1111
1111
1111
1111
